描写的に	表現
崇高でしっとりした	旋律
限りなく崇高な	美しさ
エキゾチックな情緒あふれる	旋律
すこぶるユニークな性格の	フィナーレ
流れるような	旋律
優美な	爽快感
軽快で優美な	味わい
優美で明快な	美しさ
哀愁を帯びた	カンティエーナ
情緒的な	旋律
のどかで情緒豊かな	旋律音楽
陰翳に富んだ	音色
天国的な	美しさ
ブリリアントな	音色
ひなびた	音色
格調の高い	抒情詩
暗く澄んだ	旋律
厳かな	合唱
壮大にして荘厳な	クライマックス
みずみずしく美しい	カンティレーナ
はずむような	主要主題
可憐で優美な面持ちが美しい	小品
珠玉の	小品
愛らしく親しみやすい	傑作
チャーミングで人懐っこい	語り口
神秘的で美しい	静寂
伸びやかな	カンティエーナ
洗練された	ロマンティシズム
高雅な	センティメンタリズム
ロマンチックで流れるような	旋律
甘くチャーミングな	ワルツ
ロマンチックでセンティメンタルな	情緒の美しさ
ロマンチックな夢を乗せた	旋律
ナイーブで愛らしい	子守唄


深い安らぎを豊かに湛える
高雅な雰囲気を漂わせる
悲痛な気分を盛り上げる
生き生きとした喜びが力強く湧き出る
独特のリズムが印象深い
たとえようもない魅力を醸し出す

デリケートな陰翳の妙や美しい哀愁を滲ませる
豊かなロマンとファンタジーが限りない広がりをみせる
詩的で夢想的なロマンティシズムが美しい深まりをみせる
金管楽器のダイナミックな咆哮や勇壮なリズムなどが目覚ましい
想像力のなかに潜む多面的なヴィジョンを音に結晶させる
荘厳で雄大な美観と男性的でたくましい相貌のなかに、孤高の抒情美と高潔でみずみずしいロマンティシズムが豊かに漂っている
夢想的な憧憬を秘めたロマンチックでムーディな表現がたまらない魅力を生んでいく
緩やかな伴奏の上を歌謡的な旋律が流れていく
細やかな配慮が味わい深い表現効果を実現



